bleed|Bleed| At the start of turn, take [number] damage.
hardenedcarapace|Hardened Carapace| When losing armor, gain 2 block per armor lost.
flaming|Flaming| When a card in burned, take [number] damage.
lifelink|Life Link| This unit shares health with all other units of the same name.
friendly|Friendly| You and your allies.
sting|Sting| Unit cannot heal.
immovable|Immovable| Unit cannot move or be moved.
expire|Expire| This unit will die or transform when expire runs out.
fuse|Fuse| This unit will explode when fuse runs out. Gains 1 explosive each turn.
explosive|Explosive| On death, deals [number] damage to all adjacent units.
thorns|Thorns| On recieving damage, deals [number] damage back to the attacker.
armor|Armor|Reduces incoming damage by [number], is decreased by one each hit.
block|Block|Block is removed before health when recieving damage. Excess block is removed at the start of turn.
frost|Frost|Lose strength equal to frost.
stunned|Stunned|Unit skips its turn.
trap|Terrain|Does not stop movement to this tile. Triggers its effect if a unit ends its turn here.
lootless|Emptyhanded|Does not drop loot on death.
stoneskin|Stone Skin|Block is not removed.
dazzled|Dazzled|Strength is reduced by 33 percent.
corruption|Corrupt|For every 3 stacks of corrupt, this unit takes 1 additional damage from all attacks.
stealth|Stealth|This unit can not be hit by targeted nor random attacks and effects.
rage|Rage|Rage adds 1 strength per rage.
boss|Boss|This unit is a boss.
entangled|Entangled|This unit cannot move or be moved.
nourishing|Nourishing|When this unit dies, whatever killed it gains its max health.
armorsteal|Armor Thief| When this unit reduces another unit's armor, it gains that armor.
regen|Regeneration| At the start of turn this unit heals [number].
gatheringpower|Gathering Power|The Void is gathering strength and won't attack for another [number] turns.
vulnerable:fire|Vulnerable to fire| Takes 50% extra damage from fire attacks and flaming.
immune:fire|Immune to fire| Takes no damage from fire attacks and flaming.
dodge|Dodge|Unit has a [number]% chance to avoid damage from all attacks. If an attack is dodged, 100 dodge is removed at the start of next turn.
dodgebroken|Dodge Broken|100 dodge will be removed at the start of next turn.
immune:knockback|Immune to knockback|Immune to collision damage from being pushed or pulled, or other units being pushed or pulled into it.
poison|Poison|lose 3 health at the start of turn.
feral|Feral|deal [number] extra damage the next time you deal damage
specialloot|Unique Drop|This unit will give you a special card instead of normal loot when killed
